acronym			Dash is an acronym for Debian Almquist shell(dash)
lingo			The protocol core and general lingo
weigh			their full implications must be understood and carefully weighed before choosing to do so
contravene		"May" means that the indicated action or feature does not contravene this specification
Deprecated		"Deprecated" marks an earlier technology that is no longer permitted in new accessory designs
apostrophe		convert it into the simple apostrophe character
legacy			Current Apple devices support Authentication 1.0 only as a legacy technology
revoke			The lingo command availability will be revoked if the authentication process fails
facilitate		It is sent merely to facilitate automatic baud rate detection and correction
presume			A packet with an invalid checksum receieved by an Apple device is presumed to be invalid
malform			If a SetFIDTokenValues packet is malformed
vehicle			show currently playing track information on the in-vehicle display
steer			steering wheel mounted remote control
excerpt			Song excerpt that was very end of the Bird and the Bee's rendition of Carol of the Bells
merger			This is a perfect time of year to talk about the merry-marry-mary merger
rhotic			Rhotic means that the r sound is pronounced when it occurs before a consonant sound
tether			Remote Access to Tethered Software Files
etymology		A little etymology can go a long way when it comes to old Greek words
anoint			The word Christ came from Greek, and means the anointed one
alchemy			The word alchemy seems to be particularly resilient to pronunciation changes
clay			Clay is shaped and baked to make things such as pots and bricks.
craft			art and craft
pertain			if one thing pertains to another, it relates, belongs, or applies to it
incidental		if one thing is incidental to another, it is less important than the other thing
obstruct		if something obstructs a road or path, it blocks it, stopping people or vehicles getting past
grant			if something is granted to you, you're allowed to have it
discipline		A discipline is a particular area of study
sculpture		A sculpture is a work of art that is produced by carving or shaping stone, wood, clay, or other materials
rigid			A rigid substance or object is stiff and does not bend, stretch, or twist easily
taut			Something that is taut is stretched very tight
deteriorate		If something deteriorates, it becomes worse in some way
intrude			If something intrudes on your mood or your life, it has an unwanted effect on it
Renaissance
hoof			The hooves of an animal such as a horse are the hard lower parts of its feet
sculptor		people who makes sculpture
practitioner		Doctors are sometimes refered to as practitioners or medical practioners
narrate			to provide spoken commentary for (as a movie or television show)
psychology
interpretation		explanation
narrow			
doable
astronomy
mythology		a branch of knowledge that deals with myth
Jupiter			the largest of the planets and fifth in order from the sun
oral
staff
semester		
thesis
master			a person holding an academic degree higher than a bachelor's but lower than a doctor's
poetry
poem			a composition in verse
registrar		an official recorder or keeper of records
assignment
inconvinient
enroll			to insert, register, or enter in a list, catalog
department














